NO cub.c
SO cub.c
EA cub.c
WE cub.c

C 5,    0000000000001   ,       160                       
F 111,111,111

1111111111111111
11111110000000011
10000000000000001
10100000100000101
1000000000000001
10001000100010001111
10000000000000001
10101010N01010101
10000000000000001
10001000100100001
10000000000000001
10100000100001001
10011000000000001
111 111111111111