  NO      north
SO south






WE west
EA east



F 255,50,255
C 255,30,0

        11111111111111111111111111          
      11  1000000000110000000000001
      101 11011000001110000000000001                
       1 10010000000000000000000011     
11111111101100000111000000000000111111111111111111111
100000000011000001110111111111111
11110111111111011100000010001    11
11110111111111011101010010001    101
11000000110101011100000010001    11
10000000000010001100000010001        
10000000000000001101010010001 
11000001110101011111011110N0111   
11110111 1110101 101111010001
11111111 1111111 111111111111